┌──────────┬──────────┐
│*.........│.........*│
│.┌─┐.┌──┐.╵.┌──┐.┌─┐.│
│.└─┘.└──┘...└──┘.└─┘.│
│.....................│
│.╶─╴.╷.╶──┬──╴.╷.╶─╴.│
│.....│....│....│.....│
└───┐.├───. .───┤.┌───┘
    │.│.... ....│.│
┌───┘.│.┌── ──┐.│.└───┐
│.....╵.│RC GP│.╵.....│
└───┐...└─────┘...┌───┘
    │.╷....M....╷.│
┌───┘.╵.╶──┬──╴.╵.└───┐
│..........│..........│
│.╶─┐.╶──╴.╵.╶──╴.┌─╴.│
│..*│.............│*..│
└─┐.└───╴.┌─┐.╶───┘.┌─┘
  │.......│ │.......│
  └───────┘ └───────┘
