┌──────────┬──────────┐
│*         │         *│
│ ┌─┐ ┌──┐ ╵ ┌──┐ ┌─┐ │
│ └─┘ └──┘   └──┘ └─┘ │
│                     │
│ ╶─╴ ╷ ╶──┬──╴ ╷ ╶─╴ │
│     │    │    │     │
└───┐ ├───   ───┤ ┌───┘
    │ │         │ │    
┌───┘ ╵ ┌── ──┐ ╵ └───┐
│       │RC GP│       │
└───┐   └─────┘   ┌───┘
    │ ╷    M    ╷ │    
┌───┘ ╵ ╶──┬──╴ ╵ └───┐
│          │          │
│ ╶─┐ ╶──╴ ╵ ╶──╴ ┌─╴ │
│  *│             │*  │
└─┐ └───╴ ┌─┐ ╶───┘ ┌─┘
  │       │ │       │
  └───────┘ └───────┘  
